_______________________________________________________________________
_9_____________________________________________________________________
__6____________________________________________________________________
_______________________________________________________________________
^^^^^^_________________________________________________________________
=====^bbb______________________________________________________________
=====^bbbbbb__a_____8__________________________________________________
======^^^^^^^^^^^______________________________________________________
^^^^^^^^^^^^^^^^^^^^^^^^^______________________________________________
_______________________________________________________________________
_______________________________________________________________________
_______________________________________________________________________
_______________________________________________________________________
________cccc_____6_____________________________________________________
___________________________________________________________============
___5______________________________________=================____________
_________^^^^^^^^^^^^^^^^==============================================
^^^^^^^^^==============================================================
