_____________________________________________________________________________________________________
_9___________________________________________________________________________________________________
__6__________________________________________________________________________________________________
__________________________________________________________________________________________________6__
^^^^^^_______________________________________________________________________________________________
=====^bbb________________________________________________________________________________________^^^^
=====^bbbbbb__a_____8__________________________________________________________________________^^====
======^^^^^^^^^^^____________________________________________________________________________^^======
^^^^^^^^^^^^^^^^^^^^^^^_____________________________________________________________________7^=======
____________________________________________________________________________________________7^=======
____________________________________________________________________________________________7^=======
____________________________________________________________________________________________7^=======
____________________________________________________________________________________________7^=======
________cccc_____6__________________________________________________________________________7^=======
____________________________________________________________________________________________7^=======
___5_________^^^^^^^^^^_____________________________________________________________________^========
_________^^^^========================================================================================
^^^^^^^^^============================================================================================
