________________________________
========________________________
________________________________
________________________________
________________________________
________________________________
________________________________
________________________________
=_______________________________
=_______________________________
=______=________________________
=______=________________________
========____====================
________________________________
________________________________
========____====================
========____====================
========____====================
